2,0,0,0,0,0,0,3
6,0,0,0,0,0,0,6
0,9,0,0,0,9,0,0
0,0,0,6,6,0,0,0
0,0,0,1,1,0,0,0
0,0,0,1,1,0,0,0
0,0,0,1,1,0,0,0
0,0,0,6,6,0,0,0
0,9,0,0,0,0,9,0
6,0,0,0,0,0,0,6
2,0,0,4,0,0,0,3
