2,1,0,0,0,0,1,3
0,1,1,0,0,1,1,0
6,6,1,0,0,1,6,6
0,0,1,0,0,1,0,0
0,8,0,0,0,8,0,0
0,0,8,0,0,0,8,0
0,0,1,0,0,1,0,0
0,0,1,0,0,1,0,0
6,6,1,0,0,1,6,6
0,1,1,0,0,1,1,0
2,1,0,4,0,0,1,3