1,1,1,0,0,1,1,1
9,0,1,0,0,1,0,9
6,0,1,0,0,1,0,6
0,0,6,0,0,6,8,0
0,8,0,6,6,0,0,0
1,1,1,0,0,1,1,1
8,0,1,0,0,1,0,8
0,0,0,0,0,0,0,0
9,0,2,0,0,3,0,9
0,2,0,5,0,8,3,0
2,0,0,0,0,0,0,3